44,57,0,2,3,6,6,6,1,6,6,3,6,2,6,6,6,6,4,6,6,6,5,6,3,4,5,6,6,2,6,4,6,6,6,6,6,3,4,6,6,3,2,3,6,5,6,6,6,6,3,6,5,6,3,2,3,6,6,6,1,6,6,3,4,6,6,3,2,3,6,5,6,6,6,2,3,6,6,6,3,2,3,7,57
44,54,8,12,13,10,10,10,10,10,13,48,10,10,14,12,13,10,10,48,10,10,10,13,10,10,10,11,9,13,48,10,10,10,10,10,13,10,10,10,11,9,13,10,10,10,10,10,10,13,10,48,10,11,9,13,10,10,10,10,10,48,13,10,10,10,11,9,13,10,10,10,48,10,10,13,10,10,10,10,13,13,14,15,52
44,57,16,17,18,18,21,18,18,18,21,18,18,18,19,17,21,18,18,18,18,18,18,21,18,18,18,19,17,21,18,18,18,18,18,21,21,18,18,18,19,17,21,18,18,18,18,18,18,21,18,18,18,19,17,21,18,18,18,18,18,18,21,18,18,18,19,17,21,18,18,18,18,18,18,21,18,18,18,18,21,21,22,23,57
44,56,24,25,26,26,26,26,29,26,29,26,26,29,27,25,29,26,26,26,26,26,26,29,26,26,26,27,25,29,26,26,26,26,26,26,29,26,26,26,27,25,29,26,26,26,29,26,26,29,26,26,26,27,25,29,26,26,26,29,26,26,29,26,26,26,27,25,29,26,26,26,26,26,29,29,26,26,26,26,29,29,30,31,55
44,57,32,33,34,34,37,34,34,34,50,34,34,34,35,33,34,34,34,37,34,34,34,34,34,34,34,35,33,34,34,34,37,34,34,34,34,34,34,34,35,33,34,34,34,37,34,34,34,34,34,34,34,35,33,34,34,34,37,34,34,34,34,34,34,34,35,33,34,34,34,37,34,34,34,34,34,34,34,34,37,34,38,39,57
44,57,40,43,44,41,103,103,44,44,42,44,44,102,42,43,44,43,44,44,41,43,42,42,42,44,44,44,103,44,44,41,44,44,44,42,44,44,44,44,42,43,44,44,44,44,41,46,44,44,44,44,44,102,102,44,44,44,42,44,44,44,41,43,44,44,44,103,44,44,44,44,44,41,42,44,44,46,103,103,42,43,44,47,57
44,82,83,83,82,82,82,82,83,83,83,82,82,82,82,82,82,82,82,82,83,83,82,83,82,82,82,82,82,82,82,82,82,82,82,83,82,82,82,82,82,82,82,82,82,82,82,83,82,82,82,82,82,82,82,82,82,82,83,82,82,82,83,83,82,83,82,82,82,82,82,82,83,83,83,82,82,82,82,82,82,83,82,83,82
44,82,73,81,81,81,81,81,81,81,81,81,81,81,81,81,81,81,81,81,81,81,81,81,81,81,81,81,81,81,81,81,81,81,81,81,81,81,81,81,81,81,81,71,81,81,81,81,81,81,81,81,81,81,81,81,81,81,81,81,81,81,81,81,81,81,81,81,81,81,81,81,81,81,81,81,81,81,81,81,81,81,81,74,82
44,82,70,78,82,82,82,82,82,84,82,82,82,63,64,82,82,82,82,82,82,82,82,82,82,82,82,82,82,82,82,82,82,82,82,82,82,82,82,82,82,82,82,70,82,82,82,82,82,82,82,82,82,82,82,82,82,82,82,82,82,82,82,82,82,82,82,82,82,82,82,82,82,82,82,82,82,82,82,82,84,82,82,70,82
44,82,70,82,82,82,82,82,82,82,82,82,82,67,60,64,99,82,82,82,82,82,82,82,82,82,82,82,82,82,82,82,82,82,82,64,82,82,82,82,82,82,82,69,82,82,82,82,82,82,82,82,82,82,82,82,82,82,82,82,82,59,82,82,82,82,82,82,82,82,82,82,82,82,82,82,82,82,82,82,82,82,82,70,82
44,82,69,82,82,82,82,82,82,82,82,82,82,82,82,60,65,82,82,82,82,82,82,82,84,82,82,82,82,82,82,82,82,59,61,66,65,82,82,84,82,82,82,58,82,82,82,82,82,82,82,82,82,82,82,84,82,82,82,82,82,82,82,82,82,82,82,82,82,82,82,82,82,82,82,82,82,82,82,82,82,82,82,70,82
44,82,70,82,82,82,82,82,82,82,82,82,82,82,82,82,82,84,82,82,82,82,82,82,82,82,82,82,82,82,82,82,82,82,82,60,98,82,82,82,82,82,82,70,82,82,82,84,82,82,82,82,68,82,82,82,82,82,82,82,82,82,82,82,82,82,82,82,59,82,82,82,82,82,82,82,82,59,82,82,82,82,82,70,82
44,82,70,82,82,82,82,82,82,82,82,82,82,82,82,82,82,82,82,82,78,82,82,82,82,82,82,82,82,82,82,82,82,82,82,82,82,82,82,82,82,82,82,70,82,82,82,82,82,82,82,82,82,82,82,82,82,82,82,82,82,82,82,82,82,82,82,82,82,82,82,82,82,82,82,82,82,82,82,82,82,82,82,70,82
44,82,70,82,82,82,82,82,82,84,82,82,82,82,82,82,82,82,82,59,82,82,82,82,82,82,82,82,82,82,98,82,82,82,82,82,82,82,82,82,82,82,82,70,82,82,82,82,82,82,82,82,82,82,82,82,82,82,82,82,63,67,82,82,82,82,82,82,82,82,82,82,82,82,82,82,82,82,82,82,82,82,82,58,82
44,82,70,82,82,82,82,82,82,82,84,59,82,82,82,82,82,82,82,82,82,82,82,82,82,82,82,82,82,82,82,82,82,82,82,82,82,82,82,82,82,82,82,70,82,82,82,82,82,78,82,82,82,82,82,82,82,82,82,82,61,65,82,82,82,82,82,82,82,82,82,82,82,82,82,82,82,82,82,82,82,82,82,70,82
44,82,70,82,82,82,82,82,82,82,82,82,82,82,82,82,82,82,82,82,82,82,82,82,82,82,82,82,82,82,82,82,82,82,82,78,82,82,82,84,82,82,82,70,82,82,82,82,82,82,82,82,82,82,82,82,82,82,82,82,82,82,82,82,82,82,82,82,82,82,82,82,82,84,97,88,82,82,82,82,82,82,82,70,82
44,82,70,82,82,82,82,82,82,82,82,82,82,82,82,82,82,82,82,82,82,82,82,82,82,82,82,82,82,82,82,82,82,82,82,82,82,82,82,82,82,82,82,70,82,82,82,82,82,82,82,82,82,82,82,82,82,82,82,82,82,82,82,82,82,82,82,84,82,82,82,82,82,82,82,100,88,82,82,82,82,82,82,70,82
44,82,70,82,82,82,84,82,82,78,93,87,88,82,82,82,82,82,82,82,82,82,82,82,82,60,65,98,82,82,59,82,82,82,82,82,82,82,82,82,82,82,82,70,82,82,82,82,82,82,82,82,82,82,82,82,82,82,82,82,82,82,82,82,82,82,82,82,82,82,82,82,82,82,82,93,87,86,94,82,82,82,82,70,82
44,82,70,82,82,82,82,82,93,86,85,101,88,84,82,82,82,82,82,82,82,82,82,82,82,82,82,82,82,82,82,82,82,82,82,82,82,60,67,82,82,82,82,70,82,82,82,82,82,82,82,82,82,82,82,82,82,82,82,78,82,82,82,82,82,82,82,82,82,82,82,82,82,82,82,97,85,94,82,82,82,82,82,69,82
44,82,69,82,82,82,82,78,97,101,86,96,86,95,88,82,82,82,82,82,84,82,82,82,82,82,82,82,82,82,82,82,82,82,82,82,82,82,82,82,82,82,82,70,82,82,82,82,82,82,82,82,82,82,82,82,82,82,82,82,82,82,82,82,82,82,82,82,82,82,82,82,82,82,82,82,100,82,82,82,82,82,82,70,82
44,82,70,82,82,82,82,93,95,95,94,78,82,84,82,82,82,82,82,82,82,82,82,82,82,82,82,82,82,82,82,93,88,82,82,82,82,82,82,82,82,82,82,69,82,82,82,82,82,82,82,82,82,82,82,82,82,82,82,82,82,82,82,82,82,82,82,82,82,82,82,82,82,82,82,82,82,82,82,82,82,82,82,70,82
44,82,70,82,82,82,82,82,82,82,82,82,82,82,82,82,82,82,82,82,82,82,82,82,82,82,82,82,82,82,84,96,86,82,82,82,82,82,82,82,82,82,82,70,82,82,82,82,82,82,82,82,82,82,82,82,82,84,82,82,82,82,82,82,82,82,82,82,82,82,82,82,82,82,82,82,82,82,82,59,82,82,82,70,82
44,82,70,67,82,82,82,82,82,82,82,97,85,93,82,84,82,82,82,82,82,82,82,82,82,82,82,82,82,82,93,95,101,88,82,82,82,82,82,82,82,82,82,72,82,82,82,82,82,82,82,82,82,82,82,82,82,82,82,82,82,82,82,82,82,82,82,82,82,82,59,82,82,82,82,82,82,82,85,86,84,84,82,70,82
44,82,69,82,97,87,88,82,82,82,82,82,82,82,82,82,82,82,82,82,82,82,82,82,82,82,82,82,82,82,82,100,94,59,82,82,82,82,82,82,63,82,82,70,82,82,82,82,82,82,82,82,82,82,82,82,82,82,82,82,82,82,82,82,82,82,82,82,82,82,82,82,82,82,82,82,82,84,97,101,88,78,82,70,82
44,82,70,82,82,82,82,82,82,82,82,82,82,82,82,82,82,82,82,82,82,59,82,82,82,82,82,82,82,82,82,82,82,82,82,82,82,82,82,60,66,64,82,70,82,82,82,82,82,82,82,82,82,82,82,82,82,82,82,82,82,82,82,82,82,82,82,82,82,82,82,82,82,82,82,82,84,97,94,95,96,88,82,70,82
44,82,70,82,82,82,82,82,82,82,82,82,82,82,82,82,82,82,82,82,82,82,82,82,82,82,82,82,82,82,82,82,82,82,82,82,82,82,82,82,61,62,98,70,82,82,82,82,82,82,82,82,82,82,82,82,82,82,82,82,82,82,82,82,82,82,82,82,82,82,82,82,82,82,82,82,82,82,93,85,88,78,82,70,82
44,82,70,82,82,82,85,86,94,82,82,82,82,82,82,82,82,82,82,82,82,82,82,82,82,82,82,82,82,82,82,82,82,82,82,82,82,82,82,82,82,82,82,70,82,82,82,82,82,82,82,82,82,82,82,82,82,82,82,82,82,82,59,84,82,82,82,82,82,82,82,82,82,82,82,82,84,97,100,87,85,94,82,70,82
44,82,70,82,82,82,97,101,88,82,82,82,82,82,82,82,82,82,82,82,82,82,82,82,82,82,82,82,82,82,82,82,82,82,82,82,82,82,82,82,82,82,82,70,82,82,82,82,82,82,82,82,82,82,82,82,82,82,82,82,82,82,82,82,67,82,82,82,82,82,82,82,82,82,82,82,82,82,97,86,88,82,82,70,82
44,82,70,82,82,82,82,100,82,82,82,82,82,82,82,82,82,82,82,82,82,82,82,82,82,82,82,82,82,82,82,82,82,82,82,82,82,82,82,82,82,82,82,70,82,82,82,82,82,82,82,82,82,82,82,82,82,82,82,67,82,82,67,82,82,82,82,82,82,82,82,82,82,82,82,82,82,93,95,101,88,82,82,70,82
44,82,70,82,82,97,88,82,82,82,82,82,59,82,82,82,82,82,82,82,82,82,82,82,82,82,82,82,82,82,82,82,82,82,82,82,82,82,82,82,82,82,82,70,82,82,82,82,82,82,82,82,59,82,82,67,82,82,82,82,82,82,82,82,82,82,82,82,82,82,82,82,82,82,82,82,82,82,85,86,100,82,82,70,82
44,82,58,82,82,82,82,82,82,82,82,82,82,82,82,82,82,82,82,82,82,82,82,82,82,82,82,82,82,82,82,82,82,82,82,82,82,82,82,82,84,82,82,70,82,63,99,82,82,82,82,82,82,82,82,82,82,82,82,82,64,63,64,82,67,82,82,82,82,82,82,82,82,82,82,82,82,59,97,94,82,82,82,70,82
44,82,69,82,82,82,82,82,82,82,82,82,82,82,82,82,82,82,82,82,82,82,82,82,82,82,82,82,82,82,82,82,82,82,82,84,82,82,82,82,82,82,82,69,82,61,98,82,82,82,82,82,82,82,82,82,82,82,82,82,61,66,65,82,82,64,82,82,82,82,82,82,82,82,82,82,82,82,82,82,82,82,82,70,82
44,82,70,82,82,82,82,82,82,82,82,82,82,82,82,82,82,84,82,82,82,84,82,82,82,82,82,82,82,82,59,82,82,82,82,82,82,82,82,82,82,82,82,70,82,62,67,82,82,82,67,63,82,82,82,82,82,82,82,82,92,61,65,82,82,61,65,82,82,82,82,82,67,82,82,82,82,82,82,82,82,82,82,70,82
44,82,70,82,82,82,82,82,82,82,82,82,82,82,82,82,82,82,82,82,82,82,82,82,82,82,82,82,82,82,82,82,82,82,82,82,82,82,82,82,82,82,82,70,82,82,82,82,82,82,82,92,99,67,82,82,82,82,82,82,82,82,82,82,82,82,82,82,82,82,82,82,82,82,82,82,82,82,82,82,82,82,82,70,82
44,82,70,82,82,82,82,82,82,82,82,82,82,82,82,82,82,82,82,82,82,82,82,82,82,82,82,82,82,82,82,82,82,82,82,82,82,82,82,82,82,82,82,70,82,82,82,82,82,82,82,82,92,99,82,82,82,82,82,82,82,82,82,82,82,82,82,82,82,82,82,82,82,82,82,82,82,82,82,82,82,82,82,70,82
44,82,70,82,82,82,82,82,82,82,82,82,82,82,82,82,82,93,85,95,96,88,82,82,82,82,82,82,82,82,82,82,82,82,82,82,82,82,82,82,82,82,82,70,82,82,82,78,82,82,82,82,82,82,82,82,82,82,82,82,82,82,82,82,82,82,82,82,82,82,82,63,82,82,82,82,82,82,82,82,82,82,82,70,82
44,82,70,82,82,82,82,82,82,82,82,82,82,82,82,82,82,82,94,68,82,82,82,82,82,82,82,82,82,82,82,82,82,82,82,82,82,82,82,82,82,82,82,70,82,82,82,82,82,82,82,82,82,82,82,82,82,82,82,82,82,82,82,82,82,82,82,82,82,82,82,62,98,82,82,82,82,82,82,82,82,82,82,70,82
44,82,70,82,82,84,82,82,82,82,82,82,82,82,82,82,82,82,82,82,82,82,82,82,82,82,82,82,82,82,82,82,82,82,82,82,82,82,82,82,82,82,82,70,82,82,82,82,63,67,82,82,82,82,82,82,64,82,82,82,82,82,82,82,82,82,82,82,82,82,63,64,92,99,82,82,82,82,82,82,82,82,82,70,82
44,82,70,82,82,82,82,82,82,82,82,82,82,82,82,82,82,82,82,82,82,82,82,82,82,82,82,82,82,82,82,82,82,82,82,82,82,82,82,82,82,82,82,69,82,82,82,82,61,99,82,82,82,82,82,84,62,82,82,82,82,82,82,82,82,82,82,82,82,82,61,91,65,98,82,82,82,82,82,82,82,82,82,70,82
44,82,70,82,82,82,82,82,82,82,82,82,84,82,82,82,82,82,82,82,82,82,82,67,78,67,82,82,82,82,82,82,82,82,82,82,82,82,82,82,82,82,82,70,82,82,82,82,92,98,82,82,82,82,82,82,82,82,82,82,82,82,82,82,82,82,82,82,82,82,62,92,98,82,82,82,82,82,82,82,82,82,82,70,82
44,82,70,82,82,82,82,82,82,82,82,82,82,82,82,82,82,82,82,82,82,82,82,82,82,82,82,82,82,82,82,82,82,82,82,82,82,82,82,82,82,82,82,70,82,82,82,59,82,82,82,82,82,82,82,82,82,82,82,82,82,82,82,82,82,82,82,82,82,82,92,99,82,82,82,82,82,82,82,82,82,82,82,70,82
44,82,70,82,82,82,82,82,82,82,82,82,82,82,82,82,82,82,82,82,82,82,82,82,82,82,82,82,63,65,82,82,82,82,82,82,82,82,82,82,82,82,82,70,82,82,82,82,82,82,82,82,82,82,82,82,82,82,82,82,82,82,82,82,82,84,82,82,82,82,82,92,99,82,82,82,82,82,82,82,82,82,82,70,82
44,82,70,82,82,82,82,82,82,82,82,82,82,82,82,82,82,82,82,82,82,82,82,82,82,82,82,82,60,98,82,82,82,82,82,82,82,82,82,82,82,82,82,70,82,82,82,82,82,82,82,82,82,82,82,82,82,82,82,82,82,82,82,82,82,82,82,82,82,82,82,82,82,82,82,82,82,82,82,82,82,82,82,70,82
44,82,70,82,82,82,59,82,82,82,82,82,82,82,82,82,82,82,82,82,82,82,82,82,82,82,82,82,82,82,82,82,82,82,82,82,82,82,82,82,82,82,82,70,82,82,82,82,82,82,82,82,82,82,82,82,82,82,82,82,82,62,82,82,82,82,82,82,82,82,82,82,82,82,82,82,82,82,82,82,82,82,82,70,82
44,82,70,82,82,82,82,82,82,82,82,82,82,82,82,82,82,82,82,82,82,82,82,82,82,82,82,82,82,82,82,82,82,82,82,82,82,82,59,82,82,93,94,70,82,82,82,82,82,82,82,82,82,82,82,82,82,82,82,67,82,82,82,67,82,82,82,82,82,82,82,84,82,82,82,82,82,82,82,82,82,82,82,69,82
44,82,70,82,82,82,82,82,82,82,82,82,82,87,88,82,82,82,82,82,82,82,82,82,84,82,82,82,82,82,82,82,82,82,82,82,82,82,82,89,90,85,85,69,82,82,82,82,82,82,82,82,82,82,82,82,82,82,82,82,82,82,82,82,82,82,67,82,82,82,82,82,82,82,82,82,82,82,82,82,82,82,82,70,82
44,82,70,82,82,82,82,82,82,82,82,82,97,101,94,82,82,82,82,82,82,82,82,82,84,82,82,82,82,82,82,82,82,82,82,84,82,82,97,95,87,101,94,70,82,82,82,82,82,82,82,82,82,82,82,82,59,82,82,82,82,82,82,82,82,82,82,82,82,82,67,82,82,82,78,82,82,82,82,82,82,82,82,70,82
44,82,69,82,82,82,82,82,82,82,82,93,95,85,78,84,82,82,82,82,82,82,82,82,82,82,82,82,82,82,82,82,82,82,82,82,82,82,82,93,85,96,88,70,82,82,82,82,82,82,82,82,82,82,82,82,82,67,82,82,82,82,82,82,82,82,82,82,82,82,59,82,82,82,82,82,82,82,82,82,82,82,82,70,82
44,82,77,80,80,80,80,80,80,80,80,80,80,80,80,80,80,80,80,80,80,80,80,80,80,80,80,80,80,80,80,80,80,80,80,80,80,80,80,80,80,80,80,76,80,80,80,80,80,80,80,80,80,80,80,80,80,80,80,80,80,80,80,80,80,80,80,80,80,80,80,80,80,80,80,80,80,80,80,80,80,80,80,75,82
44,79,79,79,79,79,79,79,79,79,79,79,79,79,79,79,79,79,79,79,79,79,79,79,79,79,79,79,79,79,79,79,79,79,79,79,79,79,79,79,79,79,79,79,79,79,79,79,79,79,79,79,79,79,79,79,79,79,79,79,79,79,79,79,79,79,79,79,79,79,79,79,79,79,79,79,79,79,79,79,79,79,79,79,79
